12
12
0 1 1 1 0 0 0 0 0 0 0 1
7 1 1 1 16 14 14 14 14 14 14 14
0 7 1 16 18 1 4 1 5 0 0 0
0 0 0 15 0 0 0 0 6 0 0 0
0 0 0 15 3 2 16 14 14 14 23 14
1 16 14 24 14 14 18 0 0 0 15 1
1 15 1 15 1 0 0 0 1 10 15 1
14 18 1 19 14 14 14 17 1 1 15 1
0 0 0 0 0 0 11 15 1 1 15 0
0 0 0 1 7 0 0 19 14 14 22 14
0 0 0 8 9 1 0 0 0 0 3 0
0 0 0 0 0 0 0 0 0 0 0 0