12
12
0 0 0 0 0 0 0 6 8 0 0 0
0 3 0 7 0 0 0 9 0 0 0 0
0 0 0 0 10 0 0 0 5 0 10 0
0 0 6 0 0 0 16 14 14 17 0 0
0 0 4 0 0 0 15 10 0 15 4 0
0 0 0 0 11 0 15 0 0 15 0 3
14 14 14 17 0 0 15 0 0 19 14 14
0 0 0 15 0 0 15 9 0 5 0 0
0 9 0 15 0 0 15 0 10 8 0 0
0 0 0 19 14 14 18 0 0 0 0 0
0 0 7 0 0 0 0 3 0 6 0 0
0 0 0 0 0 4 4 0 0 0 9 0