12
12
0 0 0 9 0 0 0 0 0 5 0 0
0 8 0 0 0 0 10 0 16 17 0 0
0 0 0 0 3 0 0 0 15 15 7 0
0 0 6 0 0 0 0 0 15 15 0 0
0 0 4 0 0 0 0 0 15 15 0 9
0 9 0 0 0 16 14 14 18 15 0 0
0 0 10 0 0 15 0 0 0 15 0 0
0 0 16 14 14 18 0 8 0 15 7 0
0 0 15 0 0 0 11 0 0 15 0 0
0 0 15 0 0 4 0 0 0 19 14 14
14 14 18 0 0 0 0 0 0 3 0 0
0 0 0 3 0 0 0 9 7 0 0 0