12
12
0 0 0 0 0 11 0 0 4 0 0 0
0 0 0 0 0 0 0 0 0 0 5 0
0 3 0 10 0 0 6 16 14 17 0 0
5 0 0 7 0 0 0 15 0 15 0 0
0 0 0 0 0 8 0 15 0 15 3 0
0 0 16 17 0 0 0 15 0 19 14 14
0 6 15 19 17 6 0 15 0 9 0 0
0 0 15 0 15 16 14 18 0 0 0 0
14 14 18 0 15 15 0 0 4 3 0 0
0 0 0 8 19 18 0 7 0 0 0 0
3 0 9 0 0 0 7 0 0 11 0 0
0 0 0 0 4 0 8 0 0 10 0 0