12
12
0 1 0 0 0 0 0 0 0 0 0 5
0 0 0 0 0 0 0 0 0 0 0 5
0 0 0 0 0 0 4 5 5 0 0 5
0 0 0 0 0 0 0 5 5 0 0 5
0 0 0 0 3 2 0 0 0 0 0 5
0 0 0 0 0 0 0 0 0 0 0 5
0 0 0 0 0 0 0 0 0 0 0 5
6 6 6 6 6 6 9 0 8 6 6 6
0 0 0 0 0 0 11 6 10 0 0 0
0 0 0 0 0 0 0 0 0 0 0 0
0 0 0 0 0 0 0 0 0 0 0 0
0 0 0 0 0 0 0 0 0 0 0 0