12
12
0 0 0 0 0 0 0 0 0 0 0 0
0 2 0 0 0 7 9 0 10 0 0 0
0 0 0 0 0 3 0 0 0 0 6 0
0 11 11 0 0 0 0 0 0 0 0 0
0 0 0 10 0 0 0 0 0 0 0 0
0 0 0 0 16 14 14 14 14 14 14 14
5 0 0 0 15 0 0 0 0 0 0 0
0 0 0 0 15 0 0 7 0 0 0 0
0 0 0 0 15 0 0 0 8 0 11 0
14 14 14 14 18 0 9 0 0 0 0 0 0
0 0 0 0 5 0 0 0 0 0 0 0
0 0 4 0 0 0 0 0 0 10 0 0